URL: https://tabs.ultimate-guitar.com/tab/the-birthday-party/wild-world-tabs-1670144
Artist: The Birthday Party
Song: Wild World
Genre: 
Key: 


Artist: The Birthday Party
Song: "Wild World"
Album: The Bad Seed (1983)



Standard Tuning



Rowland S. Howard (Fender Jaguar into Fender Twin Reverb)



[tab]INTRO/VERSE I:
e|------------------------------------------------------------------------|
B|------------------------------------------------------------------------|
G|------------------------------------------------------------------------|
D|------------------------------------------------------------------------|
A|------------------------------------------------------------------------|
E|------------------------------------------------------------------------|[/tab]
[tab]+
e|-------------------------------------16----15---------------------------|
B|-------------------------------------------------13----14----13---------|
G|-------------------------------------------------------------------13---|
D|------------------------------------------------------------------------|
A|------------------------------------------------------------------------|
E|------------------------------------------------------------------------|[/tab]
[tab]+
e|------------------------------------------------------------------------|
B|------------------------------------------------------------------------|
G|------------------------------------------------------------------------|
D|-15~--------------------------------------------------------------------|
A|------------------------------------------------------------------------|
E|------------------------------------------------------------------------|[/tab]
[tab]+
e|-------------------------------------16----15---------------------------|
B|-------------------------------------------------13----14----13---------|
G|-------------------------------------------------------------------13---|
D|------------------------------------------------------------------------|
A|------------------------------------------------------------------------|
E|------------------------------------------------------------------------|[/tab]
[tab]+
e|------------------------------------------------------------------------|
B|------------------------------------------------------------------------|
G|-12~--------------------------------------------------------------------|
D|------------------------------------------------------------------------|
A|------------------------------------------------------------------------|
E|------------------------------------------------------------------------|[/tab]
[tab]+
                                     * play softly
e|------------------------------------------------------------------------|
B|------------------------------------------------------------------------|
G|-------------------------------------13-13-13-13-13-13-13-13-13-13-13-13|
D|------------------------------------------------------------------------|
A|------------------------------------------------------------------------|
E|------------------------------------------------------------------------|[/tab]
[tab]+
e|------------------------------------------------------------------------|
B|------------------------------------------------------------------------|
G|-13---------------------------------------------------------------------|
D|------------------------------------------------------------------------|
A|------------------------------------------------------------------------|
E|------------------------------------------------------------------------|[/tab]
[tab]+
e|------------------------------------------------------------------------|
B|------------------------------------------------------------------------|
G|------------------------------------------------------------------------|
D|-------------------------------------10----11----10----11----10----11---|
A|------------------------------------------------------------------------|
E|------------------------------------------------------------------------|[/tab]
[tab]+
e|------------------------------------------------------------------------|
B|------------------------------------------------------------------------|
G|------------------------------------------------------------------------|
D|-10---------------------------------------------------------------------|
A|------------------------------------------------------------------------|
E|------------------------------------------------------------------------|[/tab]
[tab]+
e|-13----------------11----------------9-----------------8----------------|
B|-13----------------11----------------9-----------------8----------------|
G|------------------------------------------------------------------------|
D|------------------------------------------------------------------------|
A|------------------------------------------------------------------------|
E|------------------------------------------------------------------------|[/tab]
[tab]+
e|------------------------------------------------------------------------|
B|------------------------------------------------------------------------|
G|------------------------------------------------------------------------|
D|------------------------------------------------------------------------|
A|------------------------------------------------------------------------|
E|------------------------------------------------------------------------|[/tab]
[tab]+
e|-13----------------11----------------9-----------------8----------------|
B|-13----------------11----------------9-----------------8----------------|
G|------------------------------------------------------------------------|
D|------------------------------------------------------------------------|
A|------------------------------------------------------------------------|
E|------------------------------------------------------------------------|[/tab]



[tab]CHORUS:
e|------------------------------------------------------------------------||
B|-------8-----------9-----8-----------8-----------8-----9-----8----------||
G|-10----------10----------------10----------10----------------------10---|| x 3
D|------------------------------------------------------------------------||
A|------------------------------------------------------------------------||
E|------------------------------------------------------------------------||[/tab]
[tab]+
e|------------------------------------------------------------------------|
B|-8-----------8-----9-----8-----------8----------------------------------|
G|-------10----------------------10---------------------------------------|
D|------------------------------------------------------------------------|
A|------------------------------------------------------------------------|
E|------------------------------------------------------------------------|[/tab]



[tab]CHORUS:
Overdub
  * palm muted throughout
e|------------------------------------------------------------------------|
B|------------------------------------------------------------------------|
G|------------------------------------------------------------------------|
D|-------------------------------------------------------------------3----|
A|-------------------------------------3-----------------------3----------|
E|-1--1--1--1--1--1--1--1--1--1--1--1-------------------------------------|[/tab]
[tab]+
e|------------------------------------------------------------------------|
B|------------------------------------------------------------------------|
G|------------------------------------------------------------------------|
D|------------------------------------------------------------------------|
A|-------------------------------------3----------------------------------|
E|-1--1--1--1--1--1--1--1--1--1--1--1-------------------------------------|[/tab]
[tab]+
e|------------------------------------------------------------------------|
B|------------------------------------------------------------------------|
G|------------------------------------------------------------------------|
D|-------------------------------------------------------------------3----|
A|-------------------------------------3-----------------------3----------|
E|-1--1--1--1--1--1--1--1--1--1--1--1-------------------------------------|[/tab]
[tab]+
e|------------------------------------------------------------------------|
B|------------------------------------------------------------------------|
G|------------------------------------------------------------------------|
D|------------------------------------------------------------------------|
A|-------------------------------------3----------------------------------|
E|-1--1--1--1--1--1--1--1--1--1--1--1-------------------------------------|[/tab]



[tab]INTERLUDE/VERSE II:
e|------------------------------------------------------------------------|
B|------------------------------------------------------------------------|
G|------------------------------------------------------------------------|
D|------------------------------------------------------------------------|
A|------------------------------------------------------------------------|
E|------------------------------------------------------------------------|[/tab]
[tab]+
e|-------------------------------------16----15---------------------------|
B|-------------------------------------------------13----14----13---------|
G|-------------------------------------------------------------------13---|
D|------------------------------------------------------------------------|
A|------------------------------------------------------------------------|
E|------------------------------------------------------------------------|[/tab]
[tab]+
e|------------------------------------------------------------------------|
B|------------------------------------------------------------------------|
G|------------------------------------------------------------------------|
D|-15~--------------------------------------------------------------------|
A|------------------------------------------------------------------------|
E|------------------------------------------------------------------------|[/tab]
[tab]+
e|-------------------------------------16----15---------------------------|
B|-------------------------------------------------13----14----13---------|
G|-------------------------------------------------------------------13~--|
D|------------------------------------------------------------------------|
A|------------------------------------------------------------------------|
E|------------------------------------------------------------------------|[/tab]
[tab]+
e|------------------------------------------------------------------------|
B|------------------------------------------------------------------------|
G|-------------12~---V-----~----------------------------------------------|
D|------------------------------------------------------------------------|
A|------------------------------------------------------------------------|
E|------------------------------------------------------------------------|[/tab]
[tab]+
                                     * play softly
e|------------------------------------------------------------------------|
B|------------------------------------------------------------------------|
G|-------------------------------------13-13-13-13-13-13-13-13-13-13-13-13|
D|------------------------------------------------------------------------|
A|------------------------------------------------------------------------|
E|------------------------------------------------------------------------|[/tab]
[tab]+
e|------------------------------------------------------------------------|
B|------------------------------------------------------------------------|
G|-13---------------------------------------------------------------------|
D|------------------------------------------------------------------------|
A|------------------------------------------------------------------------|
E|------------------------------------------------------------------------|[/tab]
[tab]+
e|------------------------------------------------------------------------|
B|------------------------------------------------------------------------|
G|------------------------------------------------------------------------|
D|-------------------------------------10----11----10----11----10----11---|
A|------------------------------------------------------------------------|
E|------------------------------------------------------------------------|[/tab]
[tab]+
e|------------------------------------------------------------------------|
B|------------------------------------------------------------------------|
G|------------------------------------------------------------------------|
D|-10~--------------------------------------------------------------------|
A|------------------------------------------------------------------------|
E|------------------------------------------------------------------------|[/tab]
[tab]+
e|-------------------13----------------11----------------9----------------|
B|-------------------13----------------11----------------9----------------|
G|------------------------------------------------------------------------|
D|------------------------------------------------------------------------|
A|------------------------------------------------------------------------|
E|------------------------------------------------------------------------|[/tab]
[tab]+
e|-8----------------------------------------------------------------------|
B|-8----------------------------------------------------------------------|
G|------------------------------------------------------------------------|
D|------------------------------------------------------------------------|
A|------------------------------------------------------------------------|
E|------------------------------------------------------------------------|[/tab]
[tab]+
e|-13----------------11----------------9-----------------8----------------|
B|-13----------------11----------------9-----------------8----------------|
G|------------------------------------------------------------------------|
D|------------------------------------------------------------------------|
A|------------------------------------------------------------------------|
E|------------------------------------------------------------------------|[/tab]



[tab]INTERLUDE/OUTRO:
e|------------------------------------------------------------------------|
B|------------------------------------------------------------------------|
G|------------------------------------------------------------------------|
D|------------------------------------------------------------------------|
A|------------------------------------------------------------------------|
E|------------------------------------------------------------------------|[/tab]
[tab]+
e|-------------------------------------16----15---------------------------|
B|-------------------------------------------------13----14----13---------|
G|-------------------------------------------------------------------13---|
D|------------------------------------------------------------------------|
A|------------------------------------------------------------------------|
E|------------------------------------------------------------------------|[/tab]
[tab]+
e|------------------------------------------------------------------------|
B|------------------------------------------------------------------------|
G|-12~--------------------------------------------------------------------|
D|------------------------------------------------------------------------|
A|------------------------------------------------------------------------|
E|------------------------------------------------------------------------|[/tab]
[tab]+
e|------------------------------------------------------------------------||
B|------------------------------------------------------------------------||
G|------------------------------------------------------------------------|| x 2
D|------------------------------------------------------------------------||
A|------------------------------------------------------------------------||
E|------------------------------------------------------------------------||[/tab]
[tab]+
e|------------------------------------------------------------------------|
B|-------------------------------------------------------13----14----13---|
G|-------------------------------------12----13----12---------------------|
D|------------------------------------------------------------------------|
A|------------------------------------------------------------------------|
E|------------------------------------------------------------------------|[/tab]
[tab]+
e|-16----15~--------------------------------------------------------------|
B|------------------------------------------------------------------------|
G|------------------------------------------------------------------------|
D|------------------------------------------------------------------------|
A|------------------------------------------------------------------------|
E|------------------------------------------------------------------------|[/tab]
[tab]+
e|------------------------------------------------------------------------|
B|------------------------------------------------------------------------|
G|------------------------------------------------------------------------|
D|------------------------------------------------------------------------|
A|------------------------------------------------------------------------|
E|------------------------------------------------------------------------|[/tab]
[tab]+
e|-------------------13----------------11----------------9----------------|
B|-------------------13----------------11----------------9----------------|
G|------------------------------------------------------------------------|
D|------------------------------------------------------------------------|
A|------------------------------------------------------------------------|
E|------------------------------------------------------------------------|[/tab]
[tab]+
e|-8-----------------1-----------------3-----------------4----------------|
B|-8-----------------1-----------------3-----------------4----------------|
G|------------------------------------------------------------------------|
D|------------------------------------------------------------------------|
A|------------------------------------------------------------------------|
E|------------------------------------------------------------------------|[/tab]
[tab]+
e|-6-----------------13----------------11----------------9----------------|
B|-6-----------------13----------------11----------------9----------------|
G|------------------------------------------------------------------------|
D|------------------------------------------------------------------------|
A|------------------------------------------------------------------------|
E|------------------------------------------------------------------------|[/tab]
[tab]+
e|-8-----------------13----------------15----------------16---------------|
B|-8-----------------13----------------15----------------16---------------|
G|------------------------------------------------------------------------|
D|------------------------------------------------------------------------|
A|------------------------------------------------------------------------|
E|------------------------------------------------------------------------|[/tab]
[tab]+
e|-15----------------13----------------11----------------9----------------|
B|-15----------------13----------------11----------------9----------------|
G|------------------------------------------------------------------------|
D|------------------------------------------------------------------------|
A|------------------------------------------------------------------------|
E|------------------------------------------------------------------------|[/tab]
[tab]+
e|-8-----------------1-----------------3-----------------4----------------|
B|-8-----------------1-----------------3-----------------4----------------|
G|------------------------------------------------------------------------|
D|------------------------------------------------------------------------|
A|------------------------------------------------------------------------|
E|------------------------------------------------------------------------|[/tab]
[tab]+
e|-3-----------------13----------------11----------------9----------------|
B|-3-----------------13----------------11----------------9----------------|
G|------------------------------------------------------------------------|
D|------------------------------------------------------------------------|
A|------------------------------------------------------------------------|
E|------------------------------------------------------------------------|[/tab]
[tab]+
e|-8-----------------13----------------15----------------16----16----16---|
B|-8-----------------13----------------15----------------16----16----16---|
G|------------------------------------------------------------------------|
D|------------------------------------------------------------------------|
A|------------------------------------------------------------------------|
E|------------------------------------------------------------------------|[/tab]
[tab]+
e|-16----------16----16----------16----------16----16----------16---------|
B|-16----------16----16----------16----------16----------16----16---------|
G|------------------------------------------------------------------------|
D|------------------------------------------------------------------------|
A|------------------------------------------------------------------------|
E|------------------------------------------------------------------------|[/tab]
[tab]+
e|-------------------16---\15---------------------------------------------|
B|-------------------16---\15---------------------------------------------|
G|------------------------------------------------------------------------|
D|------------------------------------------------------------------------|
A|------------------------------------------------------------------------|
E|------------------------------------------------------------------------|[/tab]



SONG STRUCTURE:

INTRO/VERSE I
CHORUS
INTERLUDE/VERSE II
CHORUS
INTERLUDE/OUTRO



That's it.  Please leave any comments, questions, or requests.  Cheers!
-Bennyshambles78-