URL: https://tabs.ultimate-guitar.com/tab/zach-schimpf/sometimes-its-a-gray-world-tabs-2453602
Artist: Zach Schimpf
Song: Sometimes Its A Gray World
Genre: 
Key: 


[tab][Verse]
e|--------------------------------------|---------------------------------------|
B|--------------------------------------|---------------------------------------|
G|--------------------------------------|---------------------------------------|
D|--------4--------4--------4--------4--|--------4--------4--------4--------4---|
A|-----5--------5--------5--------5-----|-----5--------5--------5--------5------|
E|--5--------5--------5--------5--------|--3--------3--------3--------3---------|
   there          it             is[/tab]

[tab]e|--------------------------------------|---------------------------------------|
B|--------------------------------------|---------------------------------------|
G|--------------------------------------|---------------------------------------|
D|--------4--------4--------4--------4--|--------4--------4--------4--------4---|
A|-----5--------5--------5--------5-----|-----5--------5--------5--------5------|
E|--2--------2--------2--------3--------|--3--------3--------3--------2---------|
   that      whirlwind         gone       by[/tab]

[tab]e|--------------------------------------|---------------------------------------|
B|--------------------------------------|---------------------------------------|
G|--------------------------------------|---------------------------------------|
D|--------4--------4--------4--------4--|-------0-------------------------------|
A|-----5--------5--------5--------5-----|-------5-------------------------------|
E|--2--------2--------3--------3--------|--0----2-------------------------------| 
    a    piece   of    me    follows      and  dies[/tab]

[tab]e|--------------------------------------|---------------------------------------|
B|--------------------------------------|---------------------------------------|
G|--------------------------------------|---------------------------------------|
D|--------4--------4--------4--------4--|--------4--------4--------4--------4---|
A|-----5--------5--------5--------5-----|-----5--------5--------5--------5------|
E|--5--------5--------5--------5--------|--3--------3--------3--------3---------|
   there          it              is[/tab]

[tab]e|--------------------------------------|---------------------------------------|
B|--------------------------------------|---------------------------------------|
G|--------------------------------------|---------------------------------------|
D|--------4--------4--------4--------4--|--------4--------4--------4--------4---|
A|-----5--------5--------5--------5-----|-----5--------5--------5--------5------|
E|--2--------2--------2--------3--------|--3--------3--------3--------2---------|
   shiny      fork     in      the        road  [/tab]

[tab]e|--------------------------------------|---------------------------------------|
B|--------------------------------------|---------------------------------------|
G|--------------------------------------|---------------------------------------|
D|--------4--------4--------4--------4--|-------0-------------------------------|
A|-----5--------5--------5--------5-----|-------5-------------------------------|
E|--2--------2--------3--------3--------|--0----2-------------------------------| 
   it   taunts   and    teases    me    "don't move"[/tab]

[tab][Chorus]
e|--------------------------------------|---------------------------------------|
B|--------------------------------------|---------------------------------------|
G|--------4--------4--------4--------4--|--------4--------4--------4--------4---|
D|-----5--------5--------5--------5-----|-----5--------5--------5--------5------|
A|--5--------5--------5--------5--------|--5--------5--------5--------5---------|
E|--------------------------------------|---------------------------------------|
   overcooked                              the       idea [/tab]

[tab]e|--------------------------------------|---------------------------------------|
B|--------------------------------------|---------------------------------------|
G|--------------------------------------|---------------------------------------|
D|--------4--------4--------4--------4--|--------4--------4--------4--------4---|
A|-----5--------5--------5--------5-----|-----5--------5--------5--------5------|
E|--5--------5--------5--------5--------|--5--------5--------5--------5---------|
                                           now         it's         black[/tab]

[tab]e|--------------------------------------|---------------------------------------|
B|--------------------------------------|---------------------------------------|
G|--------4--------4--------4--------4--|--------4--------4--------4--------4---|
D|-----5--------5--------5--------5-----|-----5--------5--------5--------5------|
A|--5--------5--------5--------5--------|--5--------5--------5--------5---------|
E|--------------------------------------|---------------------------------------|
   overstayed                              my       welcome[/tab]

[tab]e|--------------------------------------|---------------------------------------|
B|--------------------------------------|---------------------------------------|
G|--------------------------------------|---------------------------------------|
D|--------4--------4--------4--------4--|--------4--------4--------4--------4---|
A|-----5--------5--------5--------5-----|-----5--------5--------5--------5------|
E|--5--------5--------5--------5--------|--5--------5--------5--------5---------|
                             now           it's          gone[/tab]

[tab]e|--------------------------------------|---------------------------------------|
B|--------------------------------------|---------------------------------------|
G|--------4--------4--------4--------4--|--------4--------4--------4--------4---|
D|-----5--------5--------5--------5-----|-----5--------5--------5--------5------|
A|--5--------5--------5--------5--------|--5--------5--------5--------5---------|
E|--------------------------------------|---------------------------------------|
   what             is           it         that's                under   [/tab]

[tab]e|--------------------------------------|---------------------------------------|
B|--------------------------------------|---------------------------------------|
G|--------------------------------------|---------------------------------------|
D|--------4--------4--------4--------4--|--------4--------4--------4--------4---|
A|-----5--------5--------5--------5-----|-----5--------5--------5--------5------|
E|--5--------5--------5--------5--------|--5--------5--------5--------5---------|
    my            control[/tab]

[tab]e|--------------------------------------|---------------------------------------|
B|--------------------------------------|---------------------------------------|
G|--------4--------4--------4--------4--|--------4--------4--------4--------4---|
D|-----5--------5--------5--------5-----|-----5--------5--------5--------5------|
A|--5--------5--------5--------5--------|--5--------5--------5--------5---------|
E|--------------------------------------|---------------------------------------|
   only                   what                a                  shaky[/tab]

[tab]e|--------------------------------------|---------------------------------------|
B|--------------------------------------|---------------------------------------|
G|--------------------------------------|---------------------------------------|
D|--------4--------4--------4--------4--|--------4--------4--------4--------4---|
A|-----5--------5--------5--------5-----|-----5--------5--------5--------5------|
E|--5--------5--------5--------5--------|--5--------5--------5--------5---------|
   grip        can         hold                            don't         move[/tab]

[tab][Outro]
e|--------------------------------------|---------------------------------------|
B|--------------------------------------|---------------------------------------|
G|--------------------------------------|---------------------------------------|
D|--------4--------4--------4--------4--|--------4--------4--------4--------4---|
A|-----5--------5--------5--------5-----|-----5--------5--------5--------5------|
E|--2--------2--------2--------2--------|--2--------2--------2--------2---------|
                                                           don't         move[/tab]

[tab]e|--------------------------------------|---------------------------------------|
B|--------------------------------------|---------------------------------------|
G|--------------------------------------|---------------------------------------|
D|--------4--------4--------4--------4--|--------4--------4--------4--------4---|
A|-----5--------5--------5--------5-----|-----5--------5--------5--------5------|
E|--3--------3--------3--------3--------|--3--------3--------3--------3---------|
                                                           don't         move[/tab]

[tab]e|--------------------------------------|---------------------------------------|
B|--------------------------------------|---------------------------------------|
G|--------------------------------------|---------------------------------------|
D|--------4--------4--------4--------4--|--------4--------4--------4--------4---|
A|-----5--------5--------5--------5-----|-----5--------5--------5--------5------|
E|--2--------2--------2--------2--------|--2--------2--------2--------2---------|
                                                           don't         move...[/tab]

[tab]e|--------------------------------------|---------------------------------------|
B|--------------------------------------|---------------------------------------|
G|--------------------------------------|---------------------------------------|
D|--------4--------4--------4--------4--|--------4--------4--------4--------4---|
A|-----5--------5--------5--------5-----|-----5--------5--------5--------5------|
E|--3--------3--------3--------3--------|--3--------3--------3--------3---------|[/tab]